                                        
 ###############  ############## ##     
 ###      ####     # ####    #    #     
 ##   ##  ##   #   #   #     #  ###     
 #   ##  ### ### ###   ##   ###  #      
 #####  ## ###    ###   ##    #  ##     
 ##   ### # ## ### ### # ###  ### #     
  ###  #  ###    ##  ###   # ### ##     
 ## ##  ###   ###  ###    ##   ###      
 # #   ##    ##      ####  ##    ##     
 ###  ####    ##  # ####  # #  ###      
  ### ##  ## ##   ### # ### ##  ###     
 ## ###  ##   ##### ###   ###  ###      
    ######   ###      ###   ### ##      
 ## ## # ########## ### #####  ##       
 ####  ###        ###      ##   ###     
 ## #### ### ### ##### ### ### ###      
 #  ##  ###    ###       ###    #       
 #  #####  ##### ######### #### ##$     
                                        
