                                        
 #################                      
 #   #        #  #                      
 #   #        #  ##################     
 #   #        #            #      #     
 #   #    #   #            #      #     
 #   #######  #   ##########      #     
 ###       #  #            #      #     
 ####################      #      #     
 #####       #                    #     
 #           #                    #     
 #           #       #            #     
 #           #       #            #     
 #           #       #            #     
             #       #            #     
  ################   ###############    
                #            #######    
                #                       
                ##########$             
                                        
